SO ./path_to_the_south_texture.eerjhf
WE ./path_to_the_west     _texture
EA ./path_to_the_east_texture
F 220,7,67
C 225,30,0
NO ./path






111111111111NO111111111111
  1000000000110000000000001
1011000001110000000000001
1001000000000000000000001
       111111111011000001110000000000011
100000000011000001110111111111111
111101111111110111000000100000011
1111011111111101110101001000111
11000000110101011100000010001
10000000000000001100000010001
10000000000000001101010010001
11000001110101011111011110N0111111111
11110111 1110101 10111101000100000001
11111111 1111111 1111111111101

111
1N1
101
111
111
