SO  textures/wall_4.xpm
WE  textures/wall_3.xpm
EA  textures/wall_2.xpm
NO  textures/wall_1.xpm


F 210,180,140
C 255,255,255





       1111111111111111111111111
       1100000000110000000000001
       1011000001110000000000001
       1001000000000000000000001
111111111011000001110000000000001
100000000011000001110111100111111
11110111111111011100000010001
11000000110101011100000010001
10000000000000001100000010001
100000000N0000001100000010001
10000000000000001100000010001
10000000000000001101010010001
10000000000000001100000010001
10000000000000001101010010001
10000000000000001100000010001
10000000000000001101010010001
10000000000000001100000010001
10000000000000001101010010001
10000000000000001100000010001
10000000000000001101010010001
10000000000000001100000010001
10000000000000001101010010001
10000000000000001100000010001
10000000000000001101010010001
10000000000000001100000010001
10000000000000001101010010001
10000000000000001100000010001
10000000000000001101010010001
10000000000000001100000010001
10000000000000001101010010001
10000000000000001100000010001
10000000000000001101010010001
10000000000000001100000010001
10000000000000001101010010001
10000000000000001100000010001
10000000000000001101010010001
10000000000000001100000010001
10000000000000001101010010001
10000000000000001100000010001
10000000000000001101010010001
10000000000000001100000010001
10000000000000001101010010001
10000000000000001100000010001
10000000000000001101010010001
10000000000000001100000010001
10000000000000001101010010001
10000000000000001100000010001
10000000000000001101010010001
10000000000000001100000010001
10000000000000001101010010001
10000000000000001100000010001
10000000000000001101010010001
10000000000000001100000010001
10000000000000001101010010001
10000000000000001100000010001
10000000000000001101010010001
10000000000000001100000010001
10000000000000001101010010001
10000000000000001100000010001
10000000000000001101010010001
10000000000000001100000010001
10000000000000001101010010001
10000000000000001100000010001
10000000000000001101010010001
10000000000000001100000010001
10000000000000001101010010001
10000000000000001100000010001
10000000000000001101010010001
10000000000000001100000010001
10000000000000001101010010001
10000000000000001100000010001
10000000000000001101010010001
10000000000000001100000010001
10000000000000001101010010001
10000000000000001100000010001
10000000000000001101010010001
10000000000000001100000010001
10000000000000001101010010001
10000000000000001100000010001
10000000000000001101010010001
10000000000000001100000010001
10000000000000001101010010001
10000000000000001100000010001
10000000000000001101010010001
10000000000000001100000010001
10000000000000001101010010001
10000000000000001100000010001
10000000000000001101010010001
10000000000000001100000010001
10000000000000001101010010001
10000000000000001100000010001
10000000000000001101010010001
10000000000000001100000010001111111111
10000000000000001101010010001
10000000000000001100000010001
10000000000000001101010010001
10000000000000001100000010001
10000000000000001101010010001
10000000000000001100000010001
10000000000000001101010010001
10000000000000001100000010001
10000000000000001101010010001
10000000000000001100000010001
10000000000000001101010010001
10000000000000001100000010001
10000000000000001101010010001
10000000000000001100000010001
10000000000000001101010010001
10000000000000001100000010001
10000000000000001101010010001
110000011101010111110111100111
11110111 1110101 101111010001
11111111 1111111 111111111111
