SO  textures/S.xpm
WE  textures/W.xpm
EA  textures/E.xpm
NO  textures/N.xpm


F 105,90,70
C 30,30,30



        1111111111111111111111111
        1000000000110000000000001
        1011000001110000000000001
        1001000000000000000000001
111111111011000001110000000000001
100000000011000001110111100011111
111101111111110111000000100011111111111111111111111111111111111111111111111111111111111111111111111111111111111111111111111111111111111111111111111111111111111111111111111111111111111111111111111111
111101111111110111010100100010000000000000000000000000000000000000000000000000000000000000000000000000000000000000000000000000000000000000000000000000000000000000000000000000000000000000000000000001
111101111111110111010100100011111111111111111111111111111111111111111111111111111111111111111111111111111111111111111111111111111111111111111111111111111111111111111111111111111111111111111111111111
11110111111111011101010010001
11110111111111011101010010001
11110111111111011101010010001
11110111111111011101010010001
11110111111111011101010010001
11110111111111011101010010001
11110111111111011101010010001
11110111111111011101010010001
11110111111111011101010010001
11110111111111011101010010001
11000000110101011100000010001
10000000000000001100000010001
10000000000000001101010010001
11000001110101011111011110N0111
11110111 1110101 101111010001
11111111 1111111 111111111111
